W
11,11
C
100
N
4
S
5,0 5,10 0,5 10,5
G
5,10 5,0 10,5 0,5
D
5,0 5,10 0,5 10,5
M
1, 1, 1, 1, 1, 0, 1, 1, 1, 1, 1
1, 1, 1, 1, 1, 0, 1, 1, 1, 1, 1
1, 1, 1, 1, 1, 0, 1, 1, 1, 1, 1
1, 1, 1, 1, 1, 0, 1, 1, 1, 1, 1
1, 1, 1, 0, 0, 0, 0, 0, 1, 1, 1
0, 0, 0, 0, 0, 0, 0, 0, 0, 0, 0
1, 1, 1, 0, 0, 0, 0, 0, 1, 1, 1
1, 1, 1, 1, 1, 0, 1, 1, 1, 1, 1
1, 1, 1, 1, 1, 0, 1, 1, 1, 1, 1
1, 1, 1, 1, 1, 0, 1, 1, 1, 1, 1
1, 1, 1, 1, 1, 0, 1, 1, 1, 1, 1
